###########
#.....#...#
#.###.#.#.#
..#...#.#.#
##..##..#.#
#..#...#..#
#.#..##..##
#.#.#...#.#
#.#.#.###.#
#...#.....#
###########
