X#XXXXXXX##XX#XXXXXX
XXXX###XX#XX###X#XXX
XXXX#XXX#XX######XXX
XXXXXXX#X#XXX####X#X
####XX###X#########X
X####X#XX#XXX######X
XX#X#X#XXXXXX####X#X
XXXXXX#X#XXXX#X#XXXX
XXXXXXX#XX..#XXXXXXX
X#XXXX#XXXX.#XXX####
##XX#X##XX#...XXX###
##X#XX##XXX##.#XXX##
#XXX#X###XXX..XXX###
##XXXX##XXX..##X#X##
####XXX###X.#...XXX#
###X#XX####...#.##X#
#XX###XX...###..#XXX
XXX#X#X#.#.....XX#XX
XXXXXX##..##XX#XX#X#
X#XXX#XXX.##XXXXXXXX
